MMMMMMMMMMMMMMMMMMMMMMMMMMMMMMMMMMMMMMMMMMMMMMMMMMMMMMMMMMMMMMMMMMMMMMMMMMMMMMMMMM
MMMMMMMMMMMMMMMMMMMMMMMMMMMMMMMMMMMMMMMMMMMMMMMMMMMMMMMMMMMMMMMMMMMMMMMMMMMMMMMMMM
MMMMMMMMMMMMMMMMMMMMMMMMMMMMMMMMMMMMMMMMMMMMMMMMMMMMMMMMMMMMMMMMMMMMMMMMMMMMMMMMMM
MMM...R...RR.R...M....RR.........R....R.....R..R......M....RR.........R....R...MMM
MMM.RRR.R.R..R..R....RRR.R.R.R..R......RRR.R.R..R..R....RRR.R.R.R..R......R..R.MMM
MMM.....R.R..M..R.RR.....R.R.R..R.R........R.R..M..R.RR.....R.R.R..R.R........RMMM
MMM.RRMMMMMMMMMMMMMMMMMMMMMMMMMMMMMMMMMMMMMMMMMMMMMMMMMMMMMMMMMMMMMMMMMMM......MMM
MMM.R.MMMMMMMMMMMMMMMMMMMMMMMMMMMMMMMMMMMMMMMMMMMMMMMMMMMMMMMMMMMMMMMMMM.......MMM
MMM.R..RMMMMMMMMMMMMMMMMMMMMMMMMMMMMMMMMMMMMMMMMMMMMMMMMMMMMMMMMMMMMM..........MMM
MMM.R..R..MMMMMMMMMMMMMMMMMMMMMMMMMMMMMMMMMMMMMMMMMMMMMMMMMMMMMMMMMMMMMM.......MMM
MMM.R..R.RRR.MMMMMMMMMMMMMMMMMMMMMMMMMMMMMMMMMMMMMMMMMMMMMMMMMMMMMMMMM.........MMM
MMMF.......R..M.MMMMMMMMMMMMMMMMMMMMMMMMMMMMMMMMMMMMMMMMMMMMMMMMMM.............MMM
MMMMMMMMMMMMMMMMMMMMMMMMMMMMMMMMMMMMMMMMMMMMMMMMMMMMMMMMMMMMMMMMMMMM....MMMMMMMMMM
MMMMMMMMMMMMMMMMMMMMMMMMMMMMMMMMMMMMMMMMMMMMMMMMMMMMMMMMMMMMMMMMMMMMM......MMMMMMM
MMMMMMMMMMMMMMMMMMMMMMMMMMMMMMMMMMMMMMMMMMMMMMMMMMMMMMMMMMMMMMMMMMMMMMMMM.....MMMM
MMMMMMMMMMMMMMMMMMMMMMMMMMMMMMMMMMMMMMMMMMMMMMMMMMMMMMMMMMMMMMMMMMM............MMM
MMM....R.M..R.....R.....R.M..R....R.R...........R.M..R.....R.....R.M..R....R.R.MMM
MMM....R.R.RR..R..R.R...R.R.RR.R..R.R...........R.R.RR..R..R.R...R.R.RR.R.MMMMMMMM
MMMRR....M.....R.....R....M....R............RR....M.....R.....R....M....MMMMMMMMMM
MMMMMMMMMMMMMMMMMMMMMMMMMMMMMMMMMMM...MMMMMMMMMMMMMMMMMMMMMMMMMMMMMMMMMMMMMMMMMMMM
MMMMMMMMMMMMMMMMMMMMMMMMMMMMMMMMMMM...MMMMMMMMMMMMMMMMMMMMMMMMMMMMMMMMMMMMMMMMMMMM
MMMMMMMMMMMMMMMMMMMMMMMMMMMMMMMMMMM...MMMMMMMMMMMMMMMMMMMMMMMMMMMMMMMMMMMMMMMMMMMM
MMM.R....M.....R.....R....M....R......MMMMMM.R....M.....R.....R....M....R......MMM
MMM.RR.R.R..RR.RRR.RRRR.R.R..R.RRR..MMMMMMMM.RR.R.R..RR.RRR.RRRR.R.R..R.RRR....MMM
MMM....R.M.......R.R....R.M......R.MMMMMMMMM....R.M.......R.R....R.M......R.RR.MMM
MMMMMMMMMMMMM...MMMMMMMMMMMMMMMMMMMMMMMMMMMM...MMMMMMMMMMMMMMMMMMMMMMMMMM....MMMMM
MMMMMMMMMMMMM...MMMMMMMMMMMMMMMMMMMMM.........MMMMMMMMMMMMMMMMMMMMMMMMMMM....MMMMM
MMMMMMMMMMM...MMMMMMMMMMMMMMMMMMM.......MMMMMMMMMMMMMMMMMMMMMMMMMMMMMMMMM....MMMMM
MMM....R....R....MMMM...R....R...M..R.MMMMMM....R....R....M......R....R...M..R.MMM
MMMRRR.R.R..R.RR.MMMMRR.R.R..RRR.R..R.MMMMMMRRR.R.R..R.RR.R..RRR.R.R..RRR.R..R.MMM
MMM......R.......MMMM.....R......M....MMMMMM......R.......M..R.....R......M....MMM
MMM.RRMMMMMMMMMMMMMMMMMMMMMMMMMMM....MMMMMMM.RRMMMMMMMMMMMMMMMMMMMMMMMMMMMMMMMMMMM
MMM...MMMMMMMMMMMMMMMMMMMMMMMMMMM....MMMMMMM...MMMMMMMMMMMMMMMMMMMMMMMMMMMMMMMMMMM
MMM.RRMMMMMMMMMMMMMMMMMMMMMMMMMMM....MMMMMMM.RRMMMMMMMMMMMMMMMMMMMMMMMMMMMMMMMMMMM
MMM..R......R...R..M..R......R..R.....MMMMMM..R......R...R..M..R......R..R.....MMM
MMM..RRR.R..R..RRR.R..RRR.R..R.RRR....MMMMMM..RRR.R..R..RRR.R..RRR.R..R.RRR..I.MMM
MMM......R.........M......R...........MMMMMM......R.........M......R...........MMM
MMMMMMMMMMMMMMMMMMMMMMMMMMMMMMMMMMMMMMMMMMMMMMMMMMMMMMMMMMMMMMMMMMMMMMMMMMMMMMMMMM
MMMMMMMMMMMMMMMMMMMMMMMMMMMMMMMMMMMMMMMMMMMMMMMMMMMMMMMMMMMMMMMMMMMMMMMMMMMMMMMMMM
MMMMMMMMMMMMMMMMMMMMMMMMMMMMMMMMMMMMMMMMMMMMMMMMMMMMMMMMMMMMMMMMMMMMMMMMMMMMMMMMMM